R 480 596

NO ./TXT/greystone.xpm

SO ./TXT/colorstone.xpm
WE ./TXT/redbrick.xpm

EA ./TXT/wood.xpm
S    ./TXT/barrel.xpm
C 251, 48, 39
F 138, 67,  67

11111
12001
10001
10S21
11111




11111
10001
10001
10001
11111

