R 620 480

NO ./TXT/zabor0.xpm


SO ./TXT/zabor.xpm


WE ./TXT/neon.xpm


EA ./TXT/redbrick.xpm

S  ./TXT/bomb_min.xpm
F 78,2 , 48
C 225,30,0



11111111111111111    11111111111
10000000100000001    10000000001
10000000100000111   100000000001
1111000000000000111111110000111111
   1000000000000200000000000200001
1110000000000000100000200000002001
100100000000000010000000000020000111111111111111111111111
111000000001111111111111111100000000000000000000000000001
100000000001          10000000000111111111111111100000011
100000000001          100000000001              10000001
100000000001          100000000001              11000001
100000000001          100000000001              10000001
11000111111           110000011111              10000111
11000111111111111    1111000111                 10000001
10000000100000001    10000000001                11100001
10000000100000001    10000000001                10000001
1111000000000000111111110000111111              10000111
   1000000000000200000000000200001              10000001
111000000000000010000020000000200111111111111111111000011
1001000000000000100N00000000000000200000000000000000000011
1110000000011111111111111111000011111111111111111111111111111111111
100000000001          100000000001                 1
100000000001          100000000001
100000000001          100000000001
100000000001          100000000001
11111111111           111111111111
100000000001          100000000001
100000000001          100000000001
100000000001          100000000001
111111111111          111111111111